1 0 0 0 0 0 0 0 0 0 0 0 0 0 0 0 0 0 0 0 0 0 0 0 0 0 0 0 0 0 0 0 0 0 0 0 0 0 0 0 0 0 0 0 0 0 0 0 0 0
0 0 0 0 0 0 0 0 0 0 0 0 0 0 0 0 0 0 0 0 0 0 0 0 0 0 0 0 0 0 0 0 0 0 0 0 0 0 0 0 0 0 0 0 0 0 0 0 0 0
0 0 0 0 0 0 0 0 0 0 0 0 0 0 0 0 0 0 0 0 0 0 0 0 0 0 0 0 0 0 0 0 0 0 0 0 0 0 0 0 0 0 0 0 0 0 0 0 0 0
0 0 0 0 0 0 0 0 0 0 0 0 0 0 0 0 0 0 0 0 0 0 0 0 0 0 0 0 0 0 0 0 0 0 0 0 0 0 0 0 0 0 0 0 0 0 0 0 0 0
0 0 0 0 0 0 0 0 0 0 0 0 0 0 0 0 0 0 0 0 0 0 0 0 0 0 0 0 0 0 0 0 0 0 0 0 0 0 0 0 0 0 0 0 0 0 0 0 0 0
0 0 0 0 0 0 0 0 0 0 0 0 0 0 0 0 0 0 0 0 0 0 0 0 0 0 0 0 0 0 0 0 0 0 0 0 0 0 0 0 0 0 0 0 0 0 0 0 0 0
0 0 0 0 0 0 0 0 0 0 0 0 0 0 0 0 0 0 0 0 0 0 0 0 0 0 0 0 0 0 0 0 0 0 0 0 0 0 0 0 0 0 0 0 0 0 0 0 0 0
0 0 0 0 0 0 0 0 0 1 2 2 2 2 2 2 2 2 2 2 2 2 2 2 2 2 2 2 2 2 2 2 2 2 2 2 2 2 6 2 3 0 0 0 0 0 0 0 0 0
0 0 0 0 0 0 0 0 0 5 11 11 11 11 11 11 11 11 11 11 11 11 6 6 21 21 6 11 11 11 11 11 11 11 11 11 11 11 11 11 4 0 0 0 0 0 0 0 0 0
0 0 0 0 0 0 0 0 0 5 11 6 6 6 6 6 6 6 6 6 6 6 6 6 22 23 6 6 6 6 6 6 6 6 6 6 6 6 6 11 4 0 0 0 0 0 0 0 0 0
0 0 0 0 0 0 0 0 0 5 11 6 12 13 13 13 13 13 13 13 13 13 14 6 22 23 6 12 13 13 13 13 13 13 13 13 13 14 6 11 4 0 0 0 0 0 0 0 0 0
0 0 0 0 0 0 0 0 0 5 11 6 15 16 16 16 16 16 16 16 16 16 17 6 22 23 6 15 16 16 16 16 16 16 16 16 16 17 6 11 4 0 0 0 0 0 0 0 0 0
0 0 0 0 0 0 0 0 0 5 11 6 15 16 16 16 16 16 16 16 16 16 17 6 22 23 6 15 16 16 16 16 16 16 16 16 16 17 6 11 4 0 0 0 0 0 0 0 0 0
0 0 0 0 0 0 0 0 0 5 11 6 15 16 16 16 16 16 16 16 16 16 17 6 22 23 6 15 16 16 16 16 16 16 16 16 16 17 6 11 4 0 0 0 0 0 0 0 0 0
0 0 0 0 0 0 0 0 0 5 11 6 15 16 16 16 16 16 16 16 16 16 17 6 22 23 6 15 16 16 16 16 16 16 16 16 16 17 6 11 4 0 0 0 0 0 0 0 0 0
0 0 0 0 0 0 0 0 0 5 11 6 18 19 19 19 19 19 19 19 19 19 20 6 22 23 6 18 19 19 19 19 19 19 19 19 19 20 6 11 4 0 0 0 0 0 0 0 0 0
0 0 0 0 0 0 0 0 0 5 6 6 6 6 6 6 6 6 6 6 6 6 6 6 22 23 6 6 6 6 6 6 6 6 6 6 6 6 6 6 4 0 0 0 0 0 0 0 0 0
0 0 0 0 0 0 0 0 0 5 28 21 21 21 21 21 21 21 21 21 21 21 21 21 26 26 21 21 21 21 21 21 21 21 21 21 21 21 21 29 4 0 0 0 0 0 0 0 0 0
0 0 0 0 0 0 0 0 0 5 22 26 26 26 26 26 26 26 26 26 26 26 26 26 26 26 26 26 26 26 26 26 26 26 26 26 26 26 26 23 4 0 0 0 0 0 0 0 0 0
0 0 0 0 0 0 0 0 0 5 22 25 25 25 25 25 25 25 25 25 25 25 25 25 25 25 25 25 25 25 25 25 25 25 25 25 25 25 25 23 4 0 0 0 0 0 0 0 0 0
0 0 0 0 0 0 0 0 0 5 27 6 6 6 6 6 6 6 6 6 6 6 6 6 6 6 6 6 6 6 6 6 6 6 6 6 6 6 6 27 4 0 0 0 0 0 0 0 0 0
0 0 0 0 0 0 0 0 0 5 27 6 6 32 32 6 6 6 6 6 6 6 6 6 33 33 6 6 6 6 6 6 6 6 6 32 32 6 6 27 4 0 0 0 0 0 0 0 0 0
0 0 0 0 0 0 0 0 0 5 27 6 6 6 6 32 32 32 32 6 6 6 6 33 33 33 33 6 6 6 6 32 32 32 32 6 6 6 6 27 4 0 0 0 0 0 0 0 0 0
0 0 0 0 0 0 0 0 0 5 27 6 6 6 6 6 6 6 32 32 6 6 33 33 33 33 33 33 6 6 32 32 6 6 6 6 6 6 6 27 4 0 0 0 0 0 0 0 0 0
0 0 0 0 0 0 0 0 0 5 27 6 6 6 6 6 6 6 6 6 6 33 33 33 33 33 33 33 33 6 6 6 6 6 6 6 6 6 6 27 4 0 0 0 0 0 0 0 0 0
0 0 0 0 0 0 0 0 0 5 27 6 6 6 6 6 6 6 6 6 6 6 6 6 6 6 6 6 6 6 6 6 6 6 6 6 6 6 6 27 4 0 0 0 0 0 0 0 0 0
0 0 0 0 0 0 0 0 0 5 27 6 12 13 13 13 13 13 13 13 13 13 13 13 13 13 13 13 13 13 13 13 13 13 13 13 13 14 6 27 4 0 0 0 0 0 0 0 0 0
0 0 0 0 0 0 0 0 0 5 27 6 15 16 16 16 16 16 16 16 16 16 16 16 16 16 16 16 16 16 16 16 16 16 16 16 16 17 6 27 4 0 0 0 0 0 0 0 0 0
0 0 0 0 0 0 0 0 0 5 27 6 15 16 16 16 16 16 16 16 16 16 16 16 16 16 16 16 16 16 16 16 16 16 16 16 16 17 6 27 4 0 0 0 0 0 0 0 0 0
0 0 0 0 0 0 0 0 0 5 27 6 15 16 16 16 16 16 16 16 16 16 16 16 16 16 16 16 16 16 16 16 16 16 16 16 16 17 6 27 4 0 0 0 0 0 0 0 0 0
0 0 0 0 0 0 0 0 0 5 27 6 15 16 16 16 16 16 16 16 16 16 16 16 16 16 16 16 16 16 16 16 16 16 16 16 16 17 6 27 4 0 0 0 0 0 0 0 0 0
0 0 0 0 0 0 0 0 0 5 27 6 18 19 19 19 19 19 19 19 19 19 19 19 19 19 19 19 19 19 19 19 19 19 19 19 19 20 6 27 4 0 0 0 0 0 0 0 0 0
0 0 0 0 0 0 0 0 0 5 27 6 6 6 6 6 6 6 6 6 6 6 6 6 6 6 6 6 6 6 6 6 6 6 6 6 6 6 6 27 4 0 0 0 0 0 0 0 0 0
0 0 0 0 0 0 0 0 0 5 27 6 6 6 6 6 6 6 6 6 6 6 6 6 6 6 6 6 6 6 6 6 6 6 6 6 6 6 6 27 4 0 0 0 0 0 0 0 0 0
0 0 0 0 0 0 0 0 0 5 27 6 6 31 31 31 31 31 6 6 6 30 30 30 30 30 30 30 6 6 6 31 31 31 31 31 6 6 6 27 4 0 0 0 0 0 0 0 0 0
0 0 0 0 0 0 0 0 0 5 27 6 6 6 6 6 6 6 6 6 6 6 6 6 6 6 6 6 6 6 6 6 6 6 6 6 6 6 6 27 4 0 0 0 0 0 0 0 0 0
0 0 0 0 0 0 0 0 0 5 22 21 21 21 21 21 21 21 21 21 21 21 21 21 21 21 21 21 21 21 21 21 21 21 21 21 21 21 21 23 4 0 0 0 0 0 0 0 0 0
0 0 0 0 0 0 0 0 0 5 24 25 25 25 25 25 25 25 25 25 25 25 25 25 25 25 25 25 25 25 25 25 25 25 25 25 25 25 25 34 4 0 0 0 0 0 0 0 0 0
0 0 0 0 0 0 0 0 0 8 9 9 9 9 9 9 9 9 9 9 9 9 9 9 9 9 9 9 9 9 9 9 9 9 9 9 9 9 9 9 10 0 0 0 0 0 0 0 0 0
0 0 0 0 0 0 0 0 0 7 7 7 7 7 7 7 7 7 7 7 7 7 7 7 7 7 7 7 7 7 7 7 7 7 7 7 7 7 7 7 7 0 0 0 0 0 0 0 0 0
0 0 0 0 0 0 0 0 0 7 7 7 7 7 7 7 7 7 7 7 7 7 7 7 7 7 7 7 7 7 7 7 7 7 7 7 7 7 7 7 7 0 0 0 0 0 0 0 0 0
0 0 0 0 0 0 0 0 0 7 7 7 7 7 7 7 7 7 7 7 7 7 7 7 7 7 7 7 7 7 7 7 7 7 7 7 7 7 7 7 7 0 0 0 0 0 0 0 0 0
0 0 0 0 0 0 0 0 0 0 0 0 0 0 0 0 0 0 0 0 0 0 0 0 0 0 0 0 0 0 0 0 0 0 0 0 0 0 0 0 0 0 0 0 0 0 0 0 0 0
0 0 0 0 0 0 0 0 0 0 0 0 0 0 0 0 0 0 0 0 0 0 0 0 0 0 0 0 0 0 0 0 0 0 0 0 0 0 0 0 0 0 0 0 0 0 0 0 0 0
0 0 0 0 0 0 0 0 0 0 0 0 0 0 0 0 0 0 0 0 0 0 0 0 0 0 0 0 0 0 0 0 0 0 0 0 0 0 0 0 0 0 0 0 0 0 0 0 0 0
0 0 0 0 0 0 0 0 0 0 0 0 0 0 0 0 0 0 0 0 0 0 0 0 0 0 0 0 0 0 0 0 0 0 0 0 0 0 0 0 0 0 0 0 0 0 0 0 0 0
0 0 0 0 0 0 0 0 0 0 0 0 0 0 0 0 0 0 0 0 0 0 0 0 0 0 0 0 0 0 0 0 0 0 0 0 0 0 0 0 0 0 0 0 0 0 0 0 0 0
0 0 0 0 0 0 0 0 0 0 0 0 0 0 0 0 0 0 0 0 0 0 0 0 0 0 0 0 0 0 0 0 0 0 0 0 0 0 0 0 0 0 0 0 0 0 0 0 0 0
0 0 0 0 0 0 0 0 0 0 0 0 0 0 0 0 0 0 0 0 0 0 0 0 0 0 0 0 0 0 0 0 0 0 0 0 0 0 0 0 0 0 0 0 0 0 0 0 0 0
0 0 0 0 0 0 0 0 0 0 0 0 0 0 0 0 0 0 0 0 0 0 0 0 0 0 0 0 0 0 0 0 0 0 0 0 0 0 0 0 0 0 0 0 0 0 0 0 0 0